###############
#      @      #
#    b   b    #
# #         ###
# #    b    # #
# #    b   o# #
#e#    b   o# #
#r#    b    # #
#a#    b    # #
###h   b o  # #
#             #
#           b #
######   ######
#      x    o*#
###############
