###############
#     x@      #
#bb         bb#
#bb         bb#
#v            #
# ooooo ooooo #
# o***o o***o #
# or2ao o*2ao #
# ooooo ooooo #
#   a   b a  v#
#  a    a   a #
#    b    b   #
#####    a ####
#*hao  1  oah*#
###############
